AsAWWAAAASSS0000000WWWWWWWWWWWW000000000000000000000000000000000000000000000000000000000000000000A
sssssssAASSS000000WWWWWWWWWWWWWW00000000000000SSSSSSSSSSSSSSSSSSSSSS000000000000000000000000000000
WAAAAAsssssssssssssWWWWWWWWWWWWWW000000000000SSSSSSSSSSSSSSSSSSSSSSS000000000000000000000000000000
WWWAAAASSSsssssssssWWWWWWWWWWWWWWW00000000000SSAAAAAAAAAAAAAAAAAAASS000000000000000000000000000000
WWWAAAAASSSSSSSSSss0RRRRRRRRRR00000000000000SSAAAAAAAAAAAAAAAAAAAASS000000000000000000000000000000
WWWWWWAASSSSSSSSSss0RRRRRRRRRR0000000000000SSAAAASSSSSSSSSSSSSSSAASS000000000000000000000000000000
000WWWAASSSSSSSSSssSRRRRRRRRRRSSSSSSSSSSSSSSSAASSSSSSSSSSSSSSSSSAASS000000000000000000000000000000
000WWWAASSSSSSSSSss0RRRRRRRRRRSSSSSSSSSSSSSSSAASSWWWWWWWWWWWWWSSAASS000000000000000000000000000000
000WWWAAASSSSSSSSssSRRRRRRRRRRSSSSSSSSSSSSSSSAASSWWWWWWWWWWWWWSSAASSS00000000000000000000000000000
000WWWWAAAAAAAAAAsssRRRRRRRRRRSSSSSSSSSSSSSSAAASSWWWWWWWWWWWWWSSAAASS00000000000000000000000000000
00WWWWWWAAAAAAAAAAssRRRRRRRRRRSSSSSSSSSSSSSSAAASSWWWWWWWWWWWWWSSSAASS00000000000000000000000000000
0000000WWWWWWWWAAAsssSSSSSSSSSSSSSSSSSSS0SSAAASSS0000000000000SSSAASS00000000000000000000000000000
0000000WWWWWWWWWAAAssSSSSSSSSSSSSSSSSSSSSSAAA00000000000000000SSSAASS00000000000000000000000000000
00WWWWWWWWWWWWWWWAAssssssssssssssssssssSSAAA000000000000000000SSSAASS00000000000000000000000000000
00WWWWWWWWWWWWWWWWAssssssssssssssssssssAAAA0000000000000000000SSSAASS00000000000000000000000000000
00WWWWWWWWWWWWWWWWWAAASSSSSSAAAAAAAAAssAAAA0000000000000000000SSSAASS00000000000000000000000000000
00WWWWWWWWWWWWWWWWWWAAASSSSAAAAAAAAAAss00000000000000000000000SSSAASS00000000000000000000000000000
00WWWWWWWWWWWWWWWWWWWAAASSAAAAAAAAAAAss00000000000000000000000SSSAASS00000000000000000000000000000
00WWWWWWWWWWWWWWWWWWWWAAAAAAAAAAAAAAAss00000000000000000000000SSSAASS00000000000000000000000000000
00WWWWWWWWWWWWWWWWWW0000AAAAAAAAAAAAAss00000000000000000000000SSSAASSS00000000000000IIIIIIIII00000
000WWWWWWWWWWWWWWWWWWWWWWWWWWWWWWWWWWss00000000000000000000000SSSAASS0000000000000IIIIIIIIII000000
0000000000000000000000000000000000000ss000AAA00000000000000000SSSAASS000000000000000IIIIIIIIII0000
0000000000000000000000000000000000000ss000AAAAAAA0000000000000SSSAASS00000000000000IIIIIIIIIII0000
0000000000000000000000000000000000000ss000WWWWWWW0000000000000SSSAASS00000000000000IIIIIIIIIIII000
0000000000000000000000000000000000000ss00WWWWWWWW0000000000000SSSAASS000000000000000000IIIIIIIII00
0000000000000000000000000000000000000ss0WWWWWWWWWW000000000000SSSAASS000000000000000000IIIIIIII000
0000000WWWWWWWWWWWWWWWWWWWWWWWWWWWWWWss00WWWWWWWW0000000000000SSSAASS000000000000000000IIIIIIII000
000000000000000000WWWWWWWWWWWWWWWWWWWssWWWWWWWWW00000000000000SSSAASS00000000000000000000000000000
0000000000000000000000WWWWWWWWWWWWWWWss0000WWWW000000000000000SSSAASS00000000000000000000000000000
000000000000000000000000WWWWWWWWWWWWWss00000000000000000000000SAAAASS00000000000000000000000000000
00000000000000000000000000WWWWWWWWW00ss000000000000000000RRRRRAAASSS000000000000000000000000000000
00000000000000000000000000000WWW00000ss00000000000000000RRRRRAAASSSS000000000000000000000000000000
000000000000000000000000000WWssssssssss0000000000000000RRRRRAAASSSSS000000000000000000000000000000
00000000000000000000000000000ssssssssss000000000000000RRRRRAAASSS000000000000000000000000000000000
0000000000000000000000WWWWWWWssWWWWWW0000000000000000RRRRRAAASSS0000000000000000000000000000000000
00000000000000000000WWWWWWWWWssWWWWWWWWW000000000000RRRRRAAASSS00000000000000000IIIII0000000000000
000000000000000000WWWWWWWWWWWssWWWWWWWWWWWW00000000RRRRRAAASSS000000000000000000IIIII0000000000000
000000000000000WWWWWWWWWWWWWWssWWWWWWWWWWWWWWW0000RRRRRAAASSS0000000000000000000IIIII0000000000000
00000000000000WWWWWWWWWWWWWWWssWWWWWWWWWWWWWWWWWWRRRRRAAASSS00000000000000000000IIIII0000000000000
00000000000000WWWIIIIIIIIIIISssSSSSSSSSSSSSSSSSSRRRRAAAASSS000000000000000000000IIIII0000000000000
00000000000000WWWIIIIIIIIIIIAssAAAAAAAAAAAAAAAAAAAAAAAASSS0000000000000000000000000000000000000000
00000000000000WWWIIIIIIIIIIIAssAAAAAAAAAAAAAAAAAAAAAAASSS00000000000000000000000000000000000000000
00000000000000WWWIIIIIIIIIIAAssSSSSSSSSSSSSSSSSSSSSSSSSSS00000000000000000000000000000000000000000
00000000000000WWWIIIIIIIIAAAAssSSSSSSSSSSSSSSSSSSSSSSSSS000000000000000000000000000000000000000000
00000000000000WWWIIIIIIIIAAASss0000000000000000000000000000000000000000000000000000000000000000000
00000000000000WWWIIIIIIIAAASSss0000000000000000000000000000000000000000000000000000000000000000000
00000000000000WWWIIIIIIAAASSSss0000000000000000000000000000000000000000000000000000000000000000000
00000000000000WWWIIIIIAAASSS0ss0000000000000000000000000000000000000000000000000000000000000000000
00000000000000WWWIIIIAAASSSSSss0000000000000000000000000000000000000000000000000000000000000000000
00000000000000WWWIIIAASSSSSSSss0000000000000000000000000000000000000000000000000000000000000000000
00000000000000WWWIIIAASSSSSSSssSS00000000000000000000000000000000000000000000000000000000000000000
00000000000000WWWIIIAASSSSSSSss0000000000000000000000000000000000000000000000000000000000000000000
00000000000000WWWIIIAASSSSSSSssSSSSSSSSSSS0000000000000000000000IIIIIIIIIIIIIIII000000000000000000
00000000000000WWIIIIAARRRRRRRssRRRRRSSSSSSSSS0000000000000000000IIIIIIIIIIIIIIII000000000000000000
00000000000000WWIIIIAARRRRRRRssRRRRRSSSSSSSSSSS00000000000000000IIIIIIIIIIIIIIII000000000000000000
00000000000000WWIIIIAARRRRRRRssRRRRRSSSSSSSSSSSSSS00000000000000IIIIIIIIIIIIIIII000000000000000000
00000000000000WWIIIIAARRRRRRRssRRRRRSSSSSSSSSSSSSSS0000000000000IIIIIIIIIIIIIIII000000000000000000
00000000000000WWIIIIAARRRRRR0ssRRRRRSSSSSSSSSSSSSSS0000000000000IIIIIIIIIIIIIIII000000000000000000
00000000000000WWIIIIAARRRRRRRssRRRRRSSSSSSSSSSSSSS000000000000000000000000000000000000000000000000
00000000000000WWIIIIAAARRRRRRssRRRRRSSSSSSSSSSSSSSSS0000000000000000000000000000000000000000000000
00000000000000WWIIIIIAAARRRRRssRRRRRRSSSSSSSSSSSSSSS0000000000000000000000000000000000000000000000
00000000000000WWIIIIIAAARRRRRssRRRRRRSSSSSSSSSSS00000000000000000000000000000000000000000000000000
00000000000000WWIIIIIIAAARRRRssRRRRRRSSSSSSSSSS000000000000000000000000000000000000000000000000000
00000000000000WWIIIIIIIAAARRRssRRRRRSSSSSSSSSS0000000000000000000000000000000000000000000000000000
00000000000000WWIIIIIIIIAAARRssRRRRSSSSSSSSSS00000000000000000000000000000000000000000000000000000
00000000000000WWIIIIIIIIIAAARssRRRSSSSSSSSSS000000000000000000000000000000000000000000000000000000
00000000000000WWIIIIIIIIIIAAAssRRSSSSSSSSSSS000000000000000000000000000000000000000000000000000000
00000000000000WWIIIIIIIIIIIAAsssssssssssssSS000000000000000000000000000000000000000000000000000000
00000000000000WWIIIIIIIIIIIIAAssssssssssssSS000000000000000000000000000000000000000000000000000000
00000000000000WWIIIIIIIIIIIIIAAASSSSSSS0ssSS0000000000000000000000000AAAAA000000000000000000000000
00000000000000WWIIIIIIIIIIIIIIAAASSSSSSSssSSSS0000000000000000000000000000000000000000000000000000
00000000000000WWIIIIIIIIIIIIIAAAAASSSSSSssSSSSSSSSSSSSS0000000000000000000000000000000000000000000
00000000000000WWIIIIIIIIIIIAAAAAAAAAAAASssssssssSSSSSSSSSSSSSSSSSSS0000000000000000000000000000000
00000000000000WWIIIIIIIIIIIAAAAAAAAAAAAAssssssssSSSSSSSSSSSSSSSSSSSSS00000000000000000000000000000
00000000000000WWIIIIIIIIAAAAAAAAAAAAAAAAAASSSSssSSSSSSSSSSSSSSSSSSSSSSSS00000000000000000000000000
00000000000000WWIIIIIIAAAAAAAAAAAAAAAAAAAAAAASssSSSSSSSSSSSSSSSSSSSSSSSSS0000000000000000000000000
00000000000000WWIIIIIAAAAAAAAAAAAAAAAAAAAAAAAAssSSSSSSSSSSSSSSSSSSSSSSSSSSS00000000000000000000000
00000000000000WWIIIIIAAAAAAAAAAAAAAAAAAAAAAAAAssSSSSSSSSSSSSSSSSSSSSSSSSSSS00000000000000000000000
00000000000000WWIIIIIAAAAAAAAAAAAAAAAAAAAAAAAAssSSSSSSSSSSSSSSSSSSSSSSSSSSS00000000000000000000000
00000000000000WWIIIIIIAAAAAAAAAAAAAAAAAAAAAAASssSSSSSSSSSSSSSSSSSSSSSSSSSSS00000000000000000000000
00000000000000WWWWWWWWWAAAAAAAAAAAAAAAAAAAAASsssSSSSSSSSSSSSSSSSSSSSSSSS00000000000000000000000000
00000000000000WWWWWWWWWWAAAAAAAAAAAAAAAAAAASSssSSSSSSSSSSSSSSSSSSSSSSS0000000000000000000000000000
00000000000000WWWWWWWWWWWAAAAAAAAAAAAAAAAASSSssSSSSSSSSSSSSSSSSSSSS0000000000000000000000000000000
00000000000000WWWWWWWWWWWWAAAAAAAAAAAAAAASSSSssSSSSSSSSSSSSSSSSSSS00000000000000000000000000000000
00000000000000WWWWWWWWWWWWWWWAAAAAAAAASSSSSSSssSSSSSSSSSSSSSSSSS0000000000000000000000000000000000
00000000000000WWWWWWWWWWWWWWWWWAAAAASSSSS00WWssWWWWWWWWWWWWWWWWWWWWWWWWWWWWWWWWWWWWWWWWWWWWWW00000
00000000000000WWWWWWWWWWWWWWWWWWWWAAASSSSS0WWssWWWWWWWWWWWWWWWWWWWWWWWWWWWWWWWWWWWWWWWWWWWWWW00000
0000000000000000WWWWWWWWWWWWWWWWWW0AAASSSSSSSssSSSSSSSSSSSSSSSSSSSSSSSSSSSSSS000000000000000000000
0000000000000000000WWWWWWWWWWWWWWWWWAAASSSSSSssSSSSSSSSSSSSSSSSSSSSSSSSSSSSSS000000000000000000000
0000000000000000000000WWWWWWWWWWWWWWWAAAAAAAAssAAAAAAAAAAAAAAAAAAAAAAAAAAAAAAAAAAA0000000000000000
0000000000000000000000000WWWWWWWWWWWWAAAAAAAAssAAAAAAAAAAAAAAAAAAAAAAAAAAAAAAAAAAA0000000000000000
0000000IIIIIIIIIIIIIIIIIIIIIIIII0000000000000ss0000IIIIIIIIIIIIIIIIIIIIIIIIIII0AAAWWWWWWWWWWWWWWWW
0000000000IIIIIIIIIIIIIIIIIIIIIIIII0000000000ss00IIIIIIIIIIIIIIIIIIIIIIIIII0000AAAWWWWWWWWWWWWWWWW
000000000000IIIIIIIIIIIIIIIIIIIIIIIII00000000ssIIIIIIIIIIIIIIIIIIIIIIIIIIIIII00AAAWWWWWWWWWWWWWWWW
000000000000IIIIIIIIIIIIIIIIIIIIIII0000000000ssssssssssssssssssssssssssssssssssAAAWWWWWWWWWWWWWWWW
00000000000000000IIIIIIIIIIIIIIIII00000000000ssssssssssssssssssssssssssssssssssAAAAWWWWWWWWWWWW000
0IIIIIIIIIIIIIIIIIIIIII00000000000000IIIIIIIIIIIIIIIIIIIIIIIIIIII00RRRRRRRRRRsssssssssssssssssssss
AIIIIIIIIIIIIIIIIIIIIII00000000000000IIIIIIIIIIIIIIIIIIIIIIIIIII00000RRRRRRRRssssssssssssssssssssA
