ssssASS0000000000000
000sASSS000000000000
000sASSSS00000000000
000sAAAASS0000000000
000ssssASS0000000000
00WWWWsASS0000000000
00WWWWsASS0000000000
00WWWWsASS0000000000
00WWWWsASS0000000000
00WWWWsASSSSSS000000
00WWWWsASSSSSSSS0000
00WWWWsAAAAAAASS0000
00WWWWsssssssASS0000
000000000000sASS0000
000000000000sASS0000
000000000000sASS0000
000000000000sASSSSSS
000000000000sASSSSSS
000000000000sAAAAAAA
000000000000sssssssD
