ssWWWWWWWSSS0000000WWWWWWWWWWWW0000000000000000000000000000000000000000000000000000000000000000000
WssssssAASSS000000WWWWWWWWWWWWWW00000000000000SSSSSSSSSSSSSSSSSSSSSS000000000000000000000000000000
WAAAAAsssssSSS000WWWWWWWWWWWWWWWW000000000000SSSSSSSSSSSSSSSSSSSSSSS000000000000000000000000000000
WWWAAAASSSssssssssWWWWWWWWWWWWWWWW00000000000SSAAAAAAAAAAAAAAAAAAASS000000000000000000000000000000
WWWAAAAASSSSSSSSSs00RRRRRRRRRR00000000000000SSAAAAAAAAAAAAAAAAAAAASS000000000000000000000000000000
WWWWWWAASSSSSSSSSs00RRRRRRRRRR0000000000000SSAAAASSSSSSSSSSSSSSSAASS000000000000000000000000000000
000WWWAASSSSSSSSSsSSRRRRRRRRRRSSSSSSSSSSSSSSSAASSSSSSSSSSSSSSSSSAASS000000000000000000000000000000
000WWWAASSSSSSSSSs00RRRRRRRRRRSSSSSSSSSSSSSSSAASSWWWWWWWWWWWWWSSAASS000000000000000000000000000000
000WWWAAASSSSSSSSsSSRRRRRRRRRRSSSSSSSSSSSSSSSAASSWWWWWWWWWWWWWSSAASSS00000000000000000000000000000
000WWWWAAAAAAAAAAssSRRRRRRRRRRSSSSSSSSSSSSSSAAASSWWWWWWWWWWWWWSSAAASS00000000000000000000000000000
00WWWWWWAAAAAAAAAAsSRRRRRRRRRRSSSSSSSSSSSSSSAAASSWWWWWWWWWWWWWSSSAASS00000000000000000000000000000
0000000WWWWWWWWAAAsssSSSSSSSSSSSSSSSSSSS0SSAAASSS0000000000000SSSAASS00000000000000000000000000000
0000000WWWWWWWWWAAASsSSSSSSSSSSSSSSSSSSSSSAAA00000000000000000SSSAASS00000000000000000000000000000
00000000000000WWWAAAsssssssssssssssssssSSAAA000000000000000000SSSAASS00000000000000000000000000000
00000000000000WWWWAAASSSSSSSSAAAAAAAAAsAAAA0000000000000000000SSSAASS00000000000000000000000000000
000000000000000WWWWAAASSSSSSAAAAAAAAAAsAAAA0000000000000000000SSSAASS00000000000000000000000000000
0000000000000000WWWWAAASSSSAAA00000000s00000000000000000000000SSSAASS00000000000000000000000000000
00000000000000000WWWWAAASSAAA000000000s00000000000000000000000SSSAASS00000000000000000000000000000
000000000000000000WWWWAAAAAA0000000000s00000000000000000000000SSSAASS00000000000000000000000000000
000000000000000000000000AAA00000000000s00000000000000000000000SSSAASSS0000000000000000000000000000
00000000000000000000000000000000000000s00000000000000000000000SSSAASS00000000000000000000000000000
00000000000000000000000000000000000000s000AAA00000000000000000SSSAASS00000000000000000000000000000
00000000000000000000000000000000000000s000AAAAAAA0000000000000SSSAASS00000000000000000000000000000
00000000000000000000000000000000000000s000WWWWWWW0000000000000SSSAASS00000000000000000000000000000
00000000000000000000000000000000000000s00WWWWWWWW0000000000000SSSAASS00000000000000000000000000000
00000000000000000000000000000000000000s0WWWWWWWWWW000000000000SSSAASS00000000000000000000000000000
00000000000000000000000000000000000000s00WWWWWWWW0000000000000SSSAASS00000000000000000000000000000
000000000000000000WWWWWWWWWWWWWWWWWWWWsWWWWWWWWW00000000000000SSSAASS00000000000000000000000000000
0000000000000000000000WWWWWWWWWWWWWWWWs0000WWWW000000000000000SSSAASS00000000000000000000000000000
000000000000000000000000WWWWWWWWWWWWW0s00000000000000000000000SAAAASS00000000000000000000000000000
00000000000000000000000000WWWWWWWWW000s000000000000000000RRRRRAAASSS000000000000000000000000000000
00000000000000000000000000000WWW000000s00000000000000000RRRRRAAASSSS000000000000000000000000000000
000000000000000000000000000WWWWWW00000s0000000000000000RRRRRAAASSSSS000000000000000000000000000000
000000000000000000000000000000sssssssss000000000000000RRRRRAAASSS000000000000000000000000000000000
0000000000000000000000WWWWWWWWsWWWWWW0000000000000000RRRRRAAASSS0000000000000000000000000000000000
00000000000000000000WWWWWWWWWWsWWWWWWWWW000000000000RRRRRAAASSS00000000000000000000000000000000000
000000000000000000WWWWWWWWWWWWsWWWWWWWWWWWW00000000RRRRRAAASSS000000000000000000000000000000000000
000000000000000WWWWWWWWWWWWWWWsWWWWWWWWWWWWWWW0000RRRRRAAASSS0000000000000000000000000000000000000
00000000000000WWWWWWWWWWWWWWWWsWWWWWWWWWWWWWWWWWWRRRRRAAASSS00000000000000000000000000000000000000
00000000000000WWWIIIIIIIIIIISSsSSSSSSSSSSSSSSSSSRRRRAAAASSS000000000000000000000000000000000000000
00000000000000WWWIIIIIIIIIIIAAsAAAAAAAAAAAAAAAAAAAAAAAASSS0000000000000000000000000000000000000000
00000000000000WWWIIIIIIIIIIIAAsAAAAAAAAAAAAAAAAAAAAAAASSS00000000000000000000000000000000000000000
00000000000000WWWIIIIIIIIIIAAAsSSSSSSSSSSSSSSSSSSSSSSSSSS00000000000000000000000000000000000000000
00000000000000WWWIIIIIIIIAAAASsSSSSSSSSSSSSSSSSSSSSSSSSS000000000000000000000000000000000000000000
00000000000000WWWIIIIIIIIAAASSs0000000000000000000000000000000000000000000000000000000000000000000
00000000000000WWWIIIIIIIAAASSSs0000000000000000000000000000000000000000000000000000000000000000000
00000000000000WWWIIIIIIAAASSS0s0000000000000000000000000000000000000000000000000000000000000000000
00000000000000WWWIIIIIAAASSS00s0000000000000000000000000000000000000000000000000000000000000000000
00000000000000WWWIIIIAAASSSSSSs0000000000000000000000000000000000000000000000000000000000000000000
00000000000000WWWIIIAASSSSSSSSs0000000000000000000000000000000000000000000000000000000000000000000
00000000000000WWWIIIAASSSSSSSSsSS00000000000000000000000000000000000000000000000000000000000000000
00000000000000WWWIIIAASSSSSSSSs0000000000000000000000000000000000000000000000000000000000000000000
00000000000000WWWIIIAASSSSSSSSsS000000000000000000000000000000000000000000000000000000000000000000
00000000000000WWIIIIAARRRRRRR0s0000000000000000000000000000000000000000000000000000000000000000000
00000000000000WWIIIIAARRRRRRR0s0000000000000000000000000000000000000000000000000000000000000000000
00000000000000WWIIIIAARRRRRRR0s0000000000000000000000000000000000000000000000000000000000000000000
00000000000000WWIIIIAARRRRRRR0s0000000000000000000000000000000000000000000000000000000000000000000
00000000000000WWIIIIAARRRRRR00s0000000000000000000000000000000000000000000000000000000000000000000
00000000000000WWIIIIAARRRRRRRRs0000000000000000000000000000000000000000000000000000000000000000000
00000000000000WWIIIIAAARRRRRRRs0000000000000000000000000000000000000000000000000000000000000000000
00000000000000WWIIIIIAAARRRRRRs0000000000000000000000000000000000000000000000000000000000000000000
00000000000000WWIIIIIAAARRRRRRs0000000000000000000000000000000000000000000000000000000000000000000
00000000000000WWIIIIIIAAARRRRRs0000000000000000000000000000000000000000000000000000000000000000000
00000000000000WWIIIIIIIAAARRRRs0000000000000000000000000000000000000000000000000000000000000000000
00000000000000WWIIIIIIIIAAARRRs0000000000000000000000000000000000000000000000000000000000000000000
00000000000000WWIIIIIIIIIAAARRs0000000000000000000000000000000000000000000000000000000000000000000
00000000000000WWIIIIIIIIIIAAARs0000000000000000000000000000000000000000000000000000000000000000000
00000000000000WWIIIIIIIIIIIAAAs0000000000000000000000000000000000000000000000000000000000000000000
00000000000000WWIIIIIIIIIIIIAAsssssssssss000000000000000000000000000000000000000000000000000000000
00000000000000WWIIIIIIIIIIIIIAAASSSSSSS0s0000000000000000000000000000AAAAA000000000000000000000000
00000000000000WWIIIIIIIIIIIIIIAAASSSSSSSsSSS000000000000000000000000000000000000000000000000000000
00000000000000WWIIIIIIIIIIIIIAAAAASSSSSSsSSSSSSSSSSSSSS0000000000000000000000000000000000000000000
00000000000000WWIIIIIIIIIIIAAAAAAAAAAAASsSSSSSSSSSSSSSSSSSSSSSSSSSS0000000000000000000000000000000
00000000000000WWIIIIIIIIIIIAAAAAAAAAAAAAsssssssSSSSSSSSSSSSSSSSSSSSSS00000000000000000000000000000
00000000000000WWIIIIIIIIAAAAAAAAAAAAAAAAAASSSSsSSSSSSSSSSSSSSSSSSSSSSSSS00000000000000000000000000
00000000000000WWIIIIIIAAAAAAAAAAAAAAAAAAAAAAASsSSSSSSSSSSSSSSSSSSSSSSSSSS0000000000000000000000000
00000000000000WWIIIIIAAAAAAAAAAAAAAAAAAAAAAAAAsSSSSSSSSSSSSSSSSSSSSSSSSSSSS00000000000000000000000
00000000000000WWIIIIIAAAAAAAAAAAAAAAAAAAAAAAAAsSSSSSSSSSSSSSSSSSSSSSSSSSSSS00000000000000000000000
00000000000000WWIIIIIAAAAAAAAAAAAAAAAAAAAAAAAAsSSSSSSSSSSSSSSSSSSSSSSSSSSSS00000000000000000000000
00000000000000WWIIIIIIAAAAAAAAAAAAAAAAAAAAAAASsSSSSSSSSSSSSSSSSSSSSSSSSSSSS00000000000000000000000
00000000000000WWWWWWWWWAAAAAAAAAAAAAAAAAAAAASssSSSSSSSSSSSSSSSSSSSSSSSSS00000000000000000000000000
00000000000000WWWWWWWWWWAAAAAAAAAAAAAAAAAAASSsSSSSSSSSSSSSSSSSSSSSSSSS0000000000000000000000000000
00000000000000WWWWWWWWWWWAAAAAAAAAAAAAAAAASSSsSSSSSSSSSSSSSSSSSSSSS0000000000000000000000000000000
00000000000000WWWWWWWWWWWWAAAAAAAAAAAAAAASSSSsSSSSSSSSSSSSSSSSSSSS00000000000000000000000000000000
00000000000000WWWWWWWWWWWWWWWAAAAAAAAASSSSSSSsSSSSSSSSSSSSSSSSSS0000000000000000000000000000000000
00000000000000WWWWWWWWWWWWWWWWWAAAAASSSSS00WWs0000000000000000000000000000000000000000000000000000
00000000000000WWWWWWWWWWWWWWWWWWWAAASSSSSWWWWsW000000000000000000000000000000000000000000000000000
00000000000000WWWWWWWWWWWWWWWWWWWWAAASSSSS0WWs0000000000000000000000000000000000000000000000000000
0000000000000000WWWWWWWWWWWWWWWWWW0AAASSSSSSSsSSSSSSSSSSSSSSSSSSSSSSSSSSSSSSS000000000000000000000
0000000000000000000WWWWWWWWWWWWWWWWWAAASSSSSSsSSSSSSSSSSSSSSSSSSSSSSSSSSSSSSS000000000000000000000
0000000000000000000000WWWWWWWWWWWWWWWAAAAAAAAsAAAAAAAAAAAAAAAAAAAAAAAAAAAAAAAAAAAA0000000000000000
0000000000000000000000000WWWWWWWWWWWWAAAAAAAAsAAAAAAAAAAAAAAAAAAAAAAAAAAAAAAAAAAAA0000000000000000
000000000000000000000000000000000000000000000s00000IIIIIIIIIIIIIIIIIIIIIIIIIII0AAAWWWWWWWWWWWWWWWW
000000000000000000000000000000000000000000000s000IIIIIIIIIIIIIIIIIIIIIIIIII0000AAAWWWWWWWWWWWWWWWW
000000000000IIIIIIIIIIIIIIIIIIIIIIIII00000000s0IIIIIIIIIIIIIIIIIIIIIIIIIIIIII00AAAWWWWWWWWWWWWWWWW
000000000000IIIIIIIIIII000000000III0000000000s000000000000000000000000000000000AAAWWWWWWWWWWWWWWWW
00000000000000000IIIIIIIIIIIIIIIII00000000000sssssssssssssssssssssssssssssssss0AAAAWWWWWWWWWWWW000
00000000000000000000000000000000000000000000000000000000000000000RRRRRRRRRRRRs0AAAAAAWWWWW00000000
0000000000000000000000000000000000000000000000000000000000000000000RRRRRRRRRRs0AAAAAAAASSSSSSS0000
000000000000000000000000000000000000000000000000000000000000000000000RRRRRRRRs0AAAAAAAAAAASSSSSS00
