WWWWWWWWW00000000000000000000000000000000000000000000000000000000000000000000000000000000000000000
WAAAAAAAA0000000000000000000000000000000000000SSSSSSSSSSSSSSSSSSSSSS000000000000000000000000000000
WAAAAAAAA000000000000000000000000000000000000SSSSSSSSSSSSSSSSSSSSSSS000000000000000000000000000000
WWWAAAA00000000000000000000000000000000000000SSAAAAAAAAAAAAAAAAAAASS000000000000000000000000000000
WWWAAAAA000000000000000000000000000000000000SSAAAAAAAAAAAAAAAAAAAASS000000000000000000000000000000
WWWWWWAA00000000000000000000000000000000000SSAAAASSSSSSSSSSSSSSSAASS000000000000000000000000000000
000WWWAA00000000000000000000000000000000000SSAASSSSSSSSSSSSSSSSSAASS000000000000000000000000000000
000WWWAA00000000000000000000000000000000000SSAASSWWWWWWWWWWWWWSSAASS000000000000000000000000000000
000WWWAAA0000000000000000000000000000000000SSAASSWWWWWWWWWWWWWSSAASSS00000000000000000000000000000
000WWWWAAAAAAAAAASS00000000000000000000000SSAAASSWWWWWWWWWWWWWSSAAASS00000000000000000000000000000
00WWWWWWAAAAAAAAAASS0000000000000000000000SSAAASSWWWWWWWWWWWWWSSSAASS00000000000000000000000000000
0000000WWWWWWWWAAASS000000000000000000000SSAAASSS00000000000000SSAASS00000000000000000000000000000
0000000WWWWWWWWWAAASS0000000SSSSSSSSSSSSSSAAA00000000000000000000AASS00000000000000000000000000000
00000000000000WWWAAASSSSSSSSSSSSSSSSSSSSSAAA000000000000000000000AASS00000000000000000000000000000
00000000000000WWWWAAASSSSSSSSAAAAAAAAAAAAAA0000000000000000000000AA0000000000000000000000000000000
000000000000000WWWWAAASSSSSSAAAAAAAAAAAAAAA0000000000000000000000AA0000000000000000000000000000000
0000000000000000WWWWAAASSSSAAA00000000000000000000000000000000000AA0000000000000000000000000000000
00000000000000000WWWWAAASSAAA000000000000000000000000000000000000AA0000000000000000000000000000000
000000000000000000WWWWAAAAAA0000000000000000000000000000000000000AA0000000000000000000000000000000
000000000000000000000000AAA00000000000000000000000000000000000000AA0000000000000000000000000000000
00000000000000000000000000000000000000000000000000000000000000000AA0000000000000000000000000000000
000000000000000000000000000000000000000000AAA00000000000000000000AA0000000000000000000000000000000
000000000000000000000000000000000000000000AAAAAAA0000000000000000AA0000000000000000000000000000000
000000000000000000000000000000000000000000WWWWWWW0000000000000000AA0000000000000000000000000000000
00000000000000000000000000000000000000000WWWWWWWW0000000000000000AA0000000000000000000000000000000
0000000000000000000000000000000000000000WWWWWWWWWW000000000000000AA0000000000000000000000000000000
00000000000000000000000000000000000000000WWWWWWWW0000000000000000AA0000000000000000000000000000000
000000000000000000000000000000000000000000WWWWWW00000000000000000AA0000000000000000000000000000000
0000000000000000000000000000000000000000000WWWW000000000000000000AA0000000000000000000000000000000
000000000000000000000000000000000000000000000000000000000000000AAAA0000000000000000000000000000000
00000000000000000000000000000000000000000000000000000000000000AAA000000000000000000000000000000000
0000000000000000000000000000000000000000000000000000000000000AAA0000000000000000000000000000000000
000000000000000000000000000000000000000000000000000000000000AAA00000000000000000000000000000000000
00000000000000000000000000000000000000000000000000000000000AAA000000000000000000000000000000000000
0000000000000000000000000000000000000000000000000000000000AAA0000000000000000000000000000000000000
000000000000000000000000000000000000000000000000000000000AAA00000000000000000000000000000000000000
00000000000000000000000000000000000000000000000000000000AAA000000000000000000000000000000000000000
0000000000000000000000000000000000000000000000000000000AAA0000000000000000000000000000000000000000
000000000000000000000000000000000000000000000000000000AAA00000000000000000000000000000000000000000
0000000000000000000000000000000000000000000000000000AAAA000000000000000000000000000000000000000000
0000000000000000000000000000AAAAAAAAAAAAAAAAAAAAAAAAAAA0000000000000000000000000000000000000000000
0000000000000000000000000000AAAAAAAAAAAAAAAAAAAAAAAAAA00000000000000000000000000000000000000000000
000000000000000000000000000AAA00000000000000000000000000000000000000000000000000000000000000000000
0000000000000000000000000AAAA000000000000000000000000000000000000000000000000000000000000000000000
0000000000000000000000000AAA0000000000000000000000000000000000000000000000000000000000000000000000
000000000000000000000000AAA00000000000000000000000000000000000000000000000000000000000000000000000
00000000000000000000000AAA000000000000000000000000000000000000000000000000000000000000000000000000
0000000000000000000000AAA0000000000000000000000000000000000000000000000000000000000000000000000000
000000000000000000000AAA00000000000000000000000000000000000000000000000000000000000000000000000000
00000000000000000000AAA000000000000000000000000000000000000000000000000000000000000000000000000000
00000000000000000000AA0000000000000000000000000000000000000000000000000000000000000000000000000000
00000000000000000000AA0000000000000000000000000000000000000000000000000000000000000000000000000000
00000000000000000000AA0000000000000000000000000000000000000000000000000000000000000000000000000000
00000000000000000000AA0000000000000000000000000000000000000000000000000000000000000000000000000000
00000000000000000000AA0000000000000000000000000000000000000000000000000000000000000000000000000000
00000000000000000000AA0000000000000000000000000000000000000000000000000000000000000000000000000000
00000000000000000000AA0000000000000000000000000000000000000000000000000000000000000000000000000000
00000000000000000000AA0000000000000000000000000000000000000000000000000000000000000000000000000000
00000000000000000000AA0000000000000000000000000000000000000000000000000000000000000000000000000000
00000000000000000000AAA000000000000000000000000000000000000000000000000000000000000000000000000000
000000000000000000000AAA00000000000000000000000000000000000000000000000000000000000000000000000000
000000000000000000000AAA00000000000000000000000000000000000000000000000000000000000000000000000000
0000000000000000000000AAA0000000000000000000000000000000000000000000000000000000000000000000000000
00000000000000000000000AAA000000000000000000000000000000000000000000000000000000000000000000000000
000000000000000000000000AAA00000000000000000000000000000000000000000000000000000000000000000000000
0000000000000000000000000AAA0000000000000000000000000000000000000000000000000000000000000000000000
00000000000000000000000000AAA000000000000000000000000000000000000000000000000000000000000000000000
000000000000000000000000000AAA00000000000000000000000000000000000000000000000000000000000000000000
0000000000000000000000000000AAA0000000000000000000000000000000000000000000000000000000000000000000
00000000000000000000000000000AAASSSSSSS000000000000000000000000000000AAAAA000000000000000000000000
000000000000000000000000000000AAASSSSSSSSSSS000000000000000000000000000000000000000000000000000000
00000000000000000000000000000AAAAASSSSSSSSSSSSSSSSSSSSS0000000000000000000000000000000000000000000
000000000000000000000000000A0AAAAAAAAAASSSSSSSSSSSSSSSSSSSSSSSSSSSS0000000000000000000000000000000
000000000000000000000000000AAAAAAAAAAAAASSSSSSSSSSSSSSSSSSSSSSSSSSSSS00000000000000000000000000000
000000000000000000000000AAAAAAAAAAAAAAAAAASSSSSSSSSSSSSSSSSSSSSSSSSSSSSS00000000000000000000000000
0000000000000000000000AAAAAAAAAAAAAAAAAAAAAAASSSSSSSSSSSSSSSSSSSSSSSSSSSS0000000000000000000000000
000000000000000000000AAAAAAAAAAAAAAAAAAAAAAAAASSSSSSSSSSSSSSSSSSSSSSSSSSSSS00000000000000000000000
000000000000000000000AAAAAAAAAAAAAAAAAAAAAAAAASSSSSSSSSSSSSSSSSSSSSSSSSSSSS00000000000000000000000
000000000000000000000AAAAAAAAAAAAAAAAAAAAAAAAASSSSSSSSSSSSSSSSSSSSSSSSSSSSS00000000000000000000000
0000000000000000000000AAAAAAAAAAAAAAAAAAAAAAASSSSSSSSSSSSSSSSSSSSSSSSSSSSSS00000000000000000000000
00000000000000000000000AAAAAAAAAAAAAAAAAAAAASSSSSSSSSSSSSSSSSSSSSSSSSSSS00000000000000000000000000
000000000000000000000000AAAAAAAAAAAAAAAAAAASSSSSSSSSSSSSSSSSSSSSSSSSSS0000000000000000000000000000
0000000000000000000000000AAAAAAAAAAAAAAAAASSSSSSSSSSSSSSSSSSSSSSSSS0000000000000000000000000000000
00000000000000000000000000AAAAAAAAAAAAAAASSSSSSSSSSSSSSSSSSSSSSSSS00000000000000000000000000000000
00000000000000000000000000000AAAAAAAAASSSSSSSSSSSSSSSSSSSSSSSSSS0000000000000000000000000000000000
0000000000000000000000000000000AAAAASSSSS00WW00000000000000000000000000000000000000000000000000000
000000000000000000000000000000000AAASSSSSWWWWWW000000000000000000000000000000000000000000000000000
0000000000000000000000000000000000AAASSSSS0WWW0000000000000000000000000000000000000000000000000000
00000000000000000000000000000000000AAASSSSSSSSSSSSSSSSSSSSSSSSSSSSSSSSSSSSSSS000000000000000000000
000000000000000000000000000000000000AAASSSSSSSSSSSSSSSSSSSSSSSSSSSSSSSSSSSSSS000000000000000000000
0000000000000000000000000000000000000AAAAAAAAAAAAAAAAAAAAAAAAAAAAAAAAAAAAAAAAAAAAA0000000000000000
0000000000000000000000000000000000000AAAAAAAAAAAAAAAAAAAAAAAAAAAAAAAAAAAAAAAAAAAAA0000000000000000
00000000000000000000000000000000000000000000000000000000000000000000000000000000000000000000000000
00000000000000000000000000000000000000000000000000000000000000000000000000000000000000000000000000
00000000000000000000000000000000000000000000000000000000000000000000000000000000000000000000000000
00000000000000000000000000000000000000000000000000000000000000000000000000000000000000000000000000
00000000000000000000000000000000000000000000000000000000000000000000000000000000000000000000000000
00000000000000000000000000000000000000000000000000000000000000000000000000000000000000000000000000
00000000000000000000000000000000000000000000000000000000000000000000000000000000000000000000000000
00000000000000000000000000000000000000000000000000000000000000000000000000000000000000000000000000
