sssssssssssWWW000000000000000000000000000000000000
sssssssssssWWWW00000000000000000000000000000000000
WWWWWWWWWssWWWWW0000000000000000000000000000000000
WWWAAAWWWssWWWW00000000000000000000000000000000000
WWAAAAWWWsssWWWW0000000000000000000000000000000000
WWAAAAAWWWssWWWW0000000000000000000000000000000000
WAAAAAAWWWssWWWW0000000000000000000000000000000000
WAAAAAAWWWssWWWWW000000000000000000000000000000000
AAAAAAAWWWssssWWW000000000000000000000000000000000
AAAAAAAAWWWsssWWWW000SSSSSSSSSSSSSSSSSSSSS00000000
AAAAAAAAAWWWssWWWW0000SSSSAAAAAAAAAAAAAAASSS000000
AAAAAAAAAWWWssWWWW0000SSSAAAAAAAAAAAAAAAAASS000000
AAAAAAAAAWWWssWWW0000SSSAAASSSSSSSSSSSSSAAASS00000
WAAAAAAAAWWWssWWW0000SSAAASSSSSSSSSSSSSSSAAASSS000
WWAAAAAAWWWWssWWWW00SSSAASSSSSSSSSSSSSSSSSAAASS000
WWWAAAAWWWWWsssWWWSSSSSAASSSSSSSSSSSSSSSSSSAAAS000
WWWSSAAWWWWWWsssAAAAAAAAASSSSSSSSSSSSSSSSSAAASS000
WWWWSAAWWWWAAAsssAAAAAAAASSSSSSSSSSSSSSSSAAASSS000
WWWWSAAWWWAAASSsssWWWWSSSSSSSSSSSSSSSSSSAAASS00000
WWWWSAAWWWAASSWWsssWWWWWWWWWSSSSSSSSSSSAAASSS00000
WWWSSAAAAAASS00WWsssssssWWWSSSSSSSSSSSAAASSSS00000
WWWSSAAAAASS000WWWssssssWWWSSSAAAAAAAAASSSS0000000
WW00SSSSSSS000000WWWWWssWWWSSAAAAAAAAAASSSS0000000
W0000000000000000WWWWWssWWWWAAASSSSSSSSS0000000000
000000000000000000WWWWssWWWAAAWWWWWSSSSSS000000000
00000SSSSSSSSSS0000WWWssWWAAAWWWWW0000000000000000
00000SSSSSSSSSSS0000WWssssssssssWWW000000000000000
000SSSAAAAAAASSS0000WWssssssssssWWWW00000000000000
0000SSAAAAAAAASSS000SSSAAASSWWssWWWWW0000000000000
000SSAAASSSSAAASSSSSSSAAASS0WWssWWW000000000000000
0SSSAAASS0SSSAAAAAAAAAAASS00WWssWWW000000000000000
SSSAAASSS00SSAAAAAAAAAASS000WWssWWW000000000000000
SSAAASSS000SSSSSSSSSSSS0000WWWssWWW000000000000000
SSSAAASS0000000000000000000WWWssWWW000000000000000
0SSSAAASS00000000000000000WWWWssWWW000000000000000
000SSAAASS0000000000000000WWWWssWWWWWW000000000000
0000SSAAASSS00000000000000WWWWssWWWWWWW00000000000
000SSSSAAASSS00000000000000WWWssssssWWWW0000000000
00000SSSAAASSSS000000000000WWWssssssWWWW0000000000
000000SSSAAASSSS000000000000WWWWWWssWWWW0000000000
00000000SSAAASSSS000000000000WWWWWssWWWW0000000000
000000000SSAAASSSSS00000000000WWWWssWWWW0000000000
0000000000SSAAASSSSS00000000000WWWssWWW00000000000
00000000000SSAAASSSS000000000000WWssWWW00000000000
000000000000SSAASSSSS00000000000WWssWWWWW000000000
SSSSSSSSSSSSSSAASSSS000000000000WWsssssWWWWWWW0000
SSSSSSSSSSSSSSAASSS0000000000000WWssssssssssWWWW00
AAAAAAAAAAASSAAASS00000000000000WWWWWssssssssWWWWW
AAAAAAAAAAAASSAASS000000000000000WWWWWWWWWWssssssD
SSSSSSSSSSSAAAASS00000000000000000WWWWWWWWWWsssssD
